LLLLLLLLLLLLLLLLLLLLLLLLLLLLLL
LAAAAAAAAAAAAAALAAAALAAAAAAAAL
LAAAAAAAAAAAAAALAAAALAAAAAAAAL
LAAAAAAAAAAAAAALAAAALAAAAAAALL
LAAAAAAAAAAAAAALAAAALAAAAAAALL
LAAAAAAAAAAAAAALAAAALAAAAAALLL
LLLLLLLLAAAAAAALAAAALAAAAAALAA
LLLLLLLLAAAAAAALAAAALAAAAAALAA
LLLLLLLLAAAAAAALAAAALAAAAAALAA
LLLLLLLLAAAAAAALAAAALAAAAAALAA
LLLLLLLLLAAAAAALAAAALAAAAALLAA
LLLAAAAALAAAAAALAAAALAAAAALAAA
LLLAAAAALAAAAAALAAAALAAAAALAAA
LLAAAAAALAAAAAALAAAALAAAAALAAA
LLAAAAALAAAAAAALAAAALAAAAALAAA
LLAAAAALAAAAAAALAAAALAAAAALAAA
LLAAAAALAAAAAAALAAAALAAAAALAAA
LLAAAAALAAAAAALLAAAALAAAAALAAA
LLAAAAALAAAAAALAAAAALAAAAALAAA
LLAAAAALAAAAAALAAAAALAAAAALLAA
LLAAAAALAAAAALLAAAAALAAAAAALAA
LLAAAAALAAAAALAAAAAALAAAAAALAA
LLAAAALLAAAAALLLLLLLLAAAAAALLA
AAAAAALAAAAAAAAAAAAAAAAAAAAALA
AAAAAALAAAAAAAAAAAAAAAAAAAAALA
AAAAAALAAAAAAAAAAAAAAAAAAAAALL
AAAAAALAAAAAAAAAAAAAAAAAAAAALL
AAAAAALAAAAAAAAAAAAAAAAAAAAALA
AAAAAALAAAAAAAAAAAAAAAAAAAALLA
AAAAAALLLLLLLLLLLLLLLLLLLLLLAA