AAAALAALLLLLLLLLLLAAAALLLLLLAA
AALLALALLAAAAAAAAAAAAAAALAAAAA
AALALAALAAAAAAAAAAAAAAAALAAAAL
AAAAAAAAAAAAAAAAAAAAAAAAALAAAL
LLLAAAAALAAAAAAAAAALLLAAALAAAA
LLLAALLAALLAAAAAAALLAALLALLAAA
LALAALAAAAAAAAAALLLAAAALLALAAA
LALAALLAAAAAAAALLAAAAAAALALAAA
AALAAALAALAAAALLAAAAAAAALALAAA
LALLAALAAAAAAALAAAAAAAAAALALAA
LAALAAALLAAAALLAAAAAAAAAALAAAA
LAALLAALLAAAALAAAAAAAAAALLALAA
LAAALAALLAAAALAAAAAAAAAALAALAA
LAAALAALALAAALAAAAAAAAALLAALAA
LAAALLALAALAALAAAAAAAALLAAALAA
LAAAALALAAALAALAAAAAALLAAALLAA
AAAAALALAAALLALAAALLLAAAAAAAAA
AAAAAAALAAAALALAALAAAAAALAALAA
LAAAALALAAAAALAALAAAALALAAALAA
AAAAALALAAAALALAAAAALLAAAAALLL
AAAAALALLLLAALAAAAAALAAAAAAAAA
ALAAALLLLAAAALAAAAALAAAAAAAAAA
AALLLLLAAAAAAAAAAALAAAAAAAAAAA
AALAALAAAAAAAAAAALLAAAAAAAAAAA
AAAAALAAAAAAALAAALAAAAAAAAAAAL
AAAAALAAAAAALAAALAAAAAAAAAAAAL
AAAAALAAAAAALAALAAAAAAAAAAAALA
AAAALAAAAAALAAALAAAAAAAAAAALAA
AAAALALALLLAAALAAAAAAAAAAALAAA
AAAALLAAAAAAALAAAAAAAAALAAAAAA